Test Maze
13
11
1.5
1.5
90
1,1,1,1,1,1,1,1,1,1,1,1,1
1,0,1,0,1,0,1,0,0,0,0,0,1
1,0,1,0,0,0,1,0,1,1,1,0,1
1,0,0,0,1,1,1,0,0,0,0,0,1
1,0,1,0,0,0,0,0,1,1,1,0,1
1,0,1,0,1,1,1,0,1,0,0,0,1
1,0,1,0,1,0,0,0,1,1,1,0,1
1,0,1,0,1,1,1,0,1,0,1,0,1
1,0,0,0,0,0,0,0,0,0,1,0,1
1,1,1,1,1,1,1,1,1,1,1,4,1
1,1,1,1,1,1,1,1,1,1,1,1,1