Samuel's Map
16
16
1.5
1.5
0
1,1,1,1,1,1,1,1,1,1,1,1,1,1,1,1
1,0,0,0,1,0,0,0,0,0,0,0,0,0,0,1
1,0,0,0,3,0,0,0,0,0,0,0,0,0,0,1
1,0,0,0,1,0,0,0,0,0,0,0,0,0,0,1
1,1,2,1,1,0,0,0,0,0,0,0,0,0,0,1
1,1,0,1,0,0,0,0,1,1,3,1,1,0,0,1
1,1,0,1,0,0,0,0,1,0,0,0,1,0,0,1
1,1,3,1,1,1,1,1,1,0,0,0,1,0,0,1
1,0,0,0,0,0,3,0,3,0,0,0,1,0,0,1
1,0,0,0,0,0,1,1,1,0,0,0,1,0,0,1
1,0,0,0,0,0,1,0,1,0,0,0,1,0,0,1
1,1,1,3,1,1,1,0,1,0,0,0,1,0,0,1
1,1,0,0,0,1,0,0,1,1,4,1,1,0,0,1
1,1,0,0,0,1,0,0,0,0,0,0,0,0,0,1
1,1,0,0,0,1,0,0,0,0,0,0,0,0,0,1
1,1,1,1,1,1,1,1,1,1,1,1,1,1,1,1